5,15

=,#,#,#,~,~,v,E,#,#,=,~,v,=,~
=,#,#,#,=,#,=,v,=,v,v,=,~,=,=
v,#,=,=,~,~,~,v,v,=,#,#,=,#,v
=,#,~,S,~,~,v,=,#,#,=,v,v,#,=
=,#,#,#,~,~,v,=,#,#,=,#,v,~,v