5,15

E,#,#,#,~,~,v,v,#,#,=,~,v,=,~
=,#,#,#,=,#,=,v,=,v,v,=,~,=,=
v,#,=,=,~,~,~,v,v,=,#,#,=,#,v
=,#,~,S,~,~,v,=,#,#,=,v,v,#,=
=,#,#,#,~,~,v,=,#,#,=,#,v,~,v